{
  "name": "Arcadia",
  "width": 30,
  "height": 24,
  "tileSize": 16,
  "tileset": "arcadia",
  "spawns": { "player": [15, 7] },
  "tileColors": {
    "0": null,
    "1": "#2a2a3e",
    "2": "#3d3552",
    "3": "#4a4268",
    "4": "#252040",
    "5": "#d06090",
    "6": "#40b060",
    "7": "#3d3552",
    "8": "#a040c0",
    "9": "#383050"
  },
  "tileNames": {
    "0": "void",
    "1": "wall",
    "2": "floor",
    "3": "floor_light",
    "4": "wall_dark",
    "5": "runouts_cabinet",
    "6": "highscore_board",
    "7": "entrance",
    "8": "neon_sign",
    "9": "cabinet"
  },
  "tiles": [
    [0,0,0,0,0,0,0,0,0,0,0,0,0,0,0,0,0,0,0,0,0,0,0,0,0,0,0,0,0,0],
    [0,0,0,0,0,0,0,0,0,0,0,0,0,0,0,0,0,0,0,0,0,0,0,0,0,0,0,0,0,0],
    [0,0,0,0,0,0,0,0,0,0,0,0,0,0,0,0,0,0,0,0,0,0,0,0,0,0,0,0,0,0],
    [0,0,0,0,0,0,0,0,0,0,0,0,0,0,0,0,0,0,0,0,0,0,0,0,0,0,0,0,0,0],
    [0,0,0,3,3,3,3,3,3,3,3,3,3,3,3,3,3,3,3,3,3,3,3,3,3,3,3,0,0,0],
    [0,0,0,3,3,3,3,3,3,3,3,3,3,3,3,3,3,3,3,3,3,3,3,3,3,3,3,0,0,0],
    [0,0,0,3,3,3,3,3,3,3,3,3,3,3,3,3,3,3,3,3,3,3,3,3,3,3,3,0,0,0],
    [0,0,0,1,1,8,1,1,1,1,1,1,1,1,7,7,7,1,1,1,1,1,1,1,8,1,1,0,0,0],
    [0,0,0,1,2,2,2,2,2,2,2,2,2,2,2,2,2,2,2,2,2,2,2,2,2,2,1,0,0,0],
    [0,0,0,1,2,9,2,9,2,2,9,2,9,2,2,2,9,2,9,2,2,9,2,9,2,2,1,0,0,0],
    [0,0,0,1,2,9,2,9,2,2,9,2,9,2,2,2,9,2,9,2,2,9,2,9,2,2,1,0,0,0],
    [0,0,0,1,2,2,2,2,2,2,2,2,2,2,2,2,2,2,2,2,2,2,2,2,2,2,1,0,0,0],
    [0,0,0,1,2,2,2,2,2,2,2,2,2,2,2,2,2,2,2,2,2,2,2,2,2,2,1,0,0,0],
    [0,0,0,1,2,9,2,9,2,2,9,2,5,2,2,2,5,2,9,2,2,9,2,9,2,2,1,0,0,0],
    [0,0,0,1,2,9,2,9,2,2,9,2,5,2,2,2,5,2,9,2,2,9,2,9,2,2,1,0,0,0],
    [0,0,0,1,2,2,2,2,2,2,2,2,2,2,2,2,2,2,2,2,2,2,2,2,2,2,1,0,0,0],
    [0,0,0,1,2,2,2,2,2,2,2,2,2,2,2,2,2,2,2,2,2,2,2,2,2,2,1,0,0,0],
    [0,0,0,1,2,9,2,9,2,2,2,2,2,2,2,2,2,2,2,2,2,9,2,9,2,2,1,0,0,0],
    [0,0,0,1,2,9,2,9,2,2,2,2,2,2,2,2,2,2,2,2,2,9,2,9,2,2,1,0,0,0],
    [0,0,0,1,2,2,2,2,2,2,2,2,2,2,2,2,2,2,2,2,2,2,2,2,2,2,1,0,0,0],
    [0,0,0,1,2,2,2,2,2,6,2,2,2,2,2,2,2,2,2,6,2,2,2,2,2,2,1,0,0,0],
    [0,0,0,1,1,1,1,1,1,1,1,1,1,1,1,1,1,1,1,1,1,1,1,1,1,1,1,0,0,0],
    [0,0,0,0,0,0,0,0,0,0,0,0,0,0,0,0,0,0,0,0,0,0,0,0,0,0,0,0,0,0],
    [0,0,0,0,0,0,0,0,0,0,0,0,0,0,0,0,0,0,0,0,0,0,0,0,0,0,0,0,0,0]
  ],
  "collisions": [
    [1,1,1,1,1,1,1,1,1,1,1,1,1,1,1,1,1,1,1,1,1,1,1,1,1,1,1,1,1,1],
    [1,1,1,1,1,1,1,1,1,1,1,1,1,1,1,1,1,1,1,1,1,1,1,1,1,1,1,1,1,1],
    [1,1,1,1,1,1,1,1,1,1,1,1,1,1,1,1,1,1,1,1,1,1,1,1,1,1,1,1,1,1],
    [1,1,1,1,1,1,1,1,1,1,1,1,1,1,1,1,1,1,1,1,1,1,1,1,1,1,1,1,1,1],
    [1,1,1,0,0,0,0,0,0,0,0,0,0,0,0,0,0,0,0,0,0,0,0,0,0,0,0,1,1,1],
    [1,1,1,0,0,0,0,0,0,0,0,0,0,0,0,0,0,0,0,0,0,0,0,0,0,0,0,1,1,1],
    [1,1,1,0,0,0,0,0,0,0,0,0,0,0,0,0,0,0,0,0,0,0,0,0,0,0,0,1,1,1],
    [1,1,1,1,1,1,1,1,1,1,1,1,1,1,0,0,0,1,1,1,1,1,1,1,1,1,1,1,1,1],
    [1,1,1,1,0,0,0,0,0,0,0,0,0,0,0,0,0,0,0,0,0,0,0,0,0,0,1,1,1,1],
    [1,1,1,1,0,1,0,1,0,0,1,0,1,0,0,0,1,0,1,0,0,1,0,1,0,0,1,1,1,1],
    [1,1,1,1,0,1,0,1,0,0,1,0,1,0,0,0,1,0,1,0,0,1,0,1,0,0,1,1,1,1],
    [1,1,1,1,0,0,0,0,0,0,0,0,0,0,0,0,0,0,0,0,0,0,0,0,0,0,1,1,1,1],
    [1,1,1,1,0,0,0,0,0,0,0,0,0,0,0,0,0,0,0,0,0,0,0,0,0,0,1,1,1,1],
    [1,1,1,1,0,1,0,1,0,0,1,0,1,0,0,0,1,0,1,0,0,1,0,1,0,0,1,1,1,1],
    [1,1,1,1,0,1,0,1,0,0,1,0,1,0,0,0,1,0,1,0,0,1,0,1,0,0,1,1,1,1],
    [1,1,1,1,0,0,0,0,0,0,0,0,0,0,0,0,0,0,0,0,0,0,0,0,0,0,1,1,1,1],
    [1,1,1,1,0,0,0,0,0,0,0,0,0,0,0,0,0,0,0,0,0,0,0,0,0,0,1,1,1,1],
    [1,1,1,1,0,1,0,1,0,0,0,0,0,0,0,0,0,0,0,0,0,1,0,1,0,0,1,1,1,1],
    [1,1,1,1,0,1,0,1,0,0,0,0,0,0,0,0,0,0,0,0,0,1,0,1,0,0,1,1,1,1],
    [1,1,1,1,0,0,0,0,0,0,0,0,0,0,0,0,0,0,0,0,0,0,0,0,0,0,1,1,1,1],
    [1,1,1,1,0,0,0,0,0,1,0,0,0,0,0,0,0,0,0,1,0,0,0,0,0,0,1,1,1,1],
    [1,1,1,1,1,1,1,1,1,1,1,1,1,1,1,1,1,1,1,1,1,1,1,1,1,1,1,1,1,1],
    [1,1,1,1,1,1,1,1,1,1,1,1,1,1,1,1,1,1,1,1,1,1,1,1,1,1,1,1,1,1],
    [1,1,1,1,1,1,1,1,1,1,1,1,1,1,1,1,1,1,1,1,1,1,1,1,1,1,1,1,1,1]
  ],
  "tileGlow": {
    "5": { "color": [208, 96, 144], "radius": 1.5, "alpha": 0.16 },
    "6": { "color": [64, 176, 96], "radius": 1.0, "alpha": 0.10 },
    "8": { "color": [192, 64, 208], "radius": 2.0, "alpha": 0.30 },
    "9": { "color": [56, 85, 160], "radius": 1.5, "alpha": 0.16 }
  },
  "ambientGlow": { "color": [160, 64, 192], "alpha": 0.06, "radius": 0.4 },
  "interactions": [
    { "x": 12, "y": 13, "type": "app", "target": "/runouts", "label": "RUNOUTS", "prompt": "PRESS E TO PLAY" },
    { "x": 16, "y": 13, "type": "app", "target": "/runouts", "label": "RUNOUTS", "prompt": "PRESS E TO PLAY" },
    { "x": 12, "y": 14, "type": "app", "target": "/runouts", "label": "RUNOUTS", "prompt": "PRESS E TO PLAY" },
    { "x": 16, "y": 14, "type": "app", "target": "/runouts", "label": "RUNOUTS", "prompt": "PRESS E TO PLAY" },
    { "x": 9, "y": 20, "type": "dialog", "label": "HIGH SCORES", "prompt": "PRESS E TO VIEW", "dialog": "TOP SCORES:\\n1. ACE — 9999\\n2. BEK — 8420\\n3. NOV — 7300\\n4. ZRO — 5100\\n5. ???  — ????" },
    { "x": 19, "y": 20, "type": "dialog", "label": "HIGH SCORES", "prompt": "PRESS E TO VIEW", "dialog": "TOP SCORES:\\n1. ACE — 9999\\n2. BEK — 8420\\n3. NOV — 7300\\n4. ZRO — 5100\\n5. ???  — ????" }
  ]
}
