{
  "name": "Dragon's Cave",
  "width": 18,
  "height": 12,
  "tileSize": 16,
  "tileset": "cave",
  "spawns": {
    "player": [2, 2]
  },
  "tileColors": {
    "0": "#0a0408",
    "1": "#3a1a14",
    "2": "#2a1a18",
    "3": "#5a2818",
    "4": "#2a0a0a",
    "5": "#702018",
    "6": "#c8a040",
    "7": "#3a1a14"
  },
  "tileNames": {
    "0": "void",
    "1": "wall",
    "2": "floor",
    "3": "entrance",
    "4": "lava",
    "5": "dragon",
    "6": "treasure",
    "7": "stalagmite"
  },
  "tiles": [
    [0, 1, 1, 1, 1, 1, 1, 1, 1, 1, 1, 1, 1, 1, 1, 1, 1, 0],
    [0, 1, 3, 2, 2, 2, 2, 7, 2, 2, 2, 2, 2, 2, 2, 2, 1, 0],
    [0, 1, 2, 2, 2, 4, 2, 2, 2, 2, 4, 2, 2, 2, 2, 2, 1, 0],
    [0, 1, 2, 2, 2, 2, 2, 2, 2, 2, 2, 2, 2, 5, 5, 5, 1, 0],
    [0, 1, 2, 7, 2, 2, 2, 2, 4, 2, 2, 2, 2, 5, 5, 5, 1, 0],
    [0, 1, 2, 2, 2, 2, 2, 2, 2, 2, 2, 2, 2, 2, 2, 2, 1, 0],
    [0, 1, 2, 2, 2, 4, 2, 2, 2, 2, 2, 6, 6, 2, 2, 2, 1, 0],
    [0, 1, 2, 2, 2, 2, 2, 2, 2, 2, 2, 6, 6, 2, 2, 2, 1, 0],
    [0, 1, 2, 2, 2, 2, 7, 2, 2, 4, 2, 2, 2, 2, 2, 2, 1, 0],
    [0, 1, 2, 2, 2, 2, 2, 2, 2, 2, 2, 2, 2, 2, 2, 2, 1, 0],
    [0, 1, 1, 1, 1, 1, 1, 1, 1, 1, 1, 1, 1, 1, 1, 1, 1, 0],
    [0, 0, 0, 0, 0, 0, 0, 0, 0, 0, 0, 0, 0, 0, 0, 0, 0, 0]
  ],
  "collisions": [
    [1, 1, 1, 1, 1, 1, 1, 1, 1, 1, 1, 1, 1, 1, 1, 1, 1, 1],
    [1, 1, 0, 0, 0, 0, 0, 1, 0, 0, 0, 0, 0, 0, 0, 0, 1, 1],
    [1, 1, 0, 0, 0, 0, 0, 0, 0, 0, 0, 0, 0, 0, 0, 0, 1, 1],
    [1, 1, 0, 0, 0, 0, 0, 0, 0, 0, 0, 0, 0, 1, 1, 1, 1, 1],
    [1, 1, 0, 1, 0, 0, 0, 0, 0, 0, 0, 0, 0, 1, 1, 1, 1, 1],
    [1, 1, 0, 0, 0, 0, 0, 0, 0, 0, 0, 0, 0, 0, 0, 0, 1, 1],
    [1, 1, 0, 0, 0, 0, 0, 0, 0, 0, 0, 1, 1, 0, 0, 0, 1, 1],
    [1, 1, 0, 0, 0, 0, 0, 0, 0, 0, 0, 1, 1, 0, 0, 0, 1, 1],
    [1, 1, 0, 0, 0, 0, 1, 0, 0, 0, 0, 0, 0, 0, 0, 0, 1, 1],
    [1, 1, 0, 0, 0, 0, 0, 0, 0, 0, 0, 0, 0, 0, 0, 0, 1, 1],
    [1, 1, 1, 1, 1, 1, 1, 1, 1, 1, 1, 1, 1, 1, 1, 1, 1, 1],
    [1, 1, 1, 1, 1, 1, 1, 1, 1, 1, 1, 1, 1, 1, 1, 1, 1, 1]
  ],
  "interactions": [
    {
      "x": 2,
      "y": 1,
      "type": "leave_world",
      "leaveTo": "lumar-crimson",
      "label": "ENTRANCE",
      "prompt": "RETURN TO SHIP"
    },
    {
      "x": 14,
      "y": 4,
      "type": "dialog",
      "label": "DRAGON",
      "prompt": "PRESS E TO APPROACH",
      "dialog": "THE DRAGON OPENS AN EYE.\\n\\n\"FEW PILOTS DESCEND HERE.\\nFEWER STILL LEAVE.\"\\n\\nIT YAWNS, SHOWING TEETH."
    },
    {
      "x": 11,
      "y": 6,
      "type": "dialog",
      "label": "HOARD",
      "prompt": "PRESS E TO LOOK",
      "dialog": "GOLD COINS, GEMS,\\nSPORE-CRYSTALS WORTH\\nA THOUSAND VOYAGES.\\n\\nYOU DO NOT TAKE ANY."
    }
  ]
}
