{
  "5": [
    {
      "id": "5a",
      "grid": [
        [1,1,1,1,1],
        [1,0,1,0,1],
        [1,1,1,1,1],
        [1,0,1,0,1],
        [1,1,1,1,1]
      ]
    },
    {
      "id": "5b",
      "grid": [
        [1,1,1,1,1],
        [1,1,1,0,1],
        [1,1,1,1,1],
        [1,0,1,1,1],
        [1,1,1,1,1]
      ]
    },
    {
      "id": "5c",
      "grid": [
        [1,1,0,1,1],
        [1,1,1,1,1],
        [1,1,1,1,1],
        [1,1,1,1,1],
        [1,1,0,1,1]
      ]
    },
    {
      "id": "5d",
      "grid": [
        [1,1,1,1,1],
        [1,1,0,1,1],
        [1,0,1,0,1],
        [1,1,0,1,1],
        [1,1,1,1,1]
      ]
    },
    {
      "id": "5e",
      "grid": [
        [0,1,1,1,1],
        [1,1,1,1,1],
        [1,1,1,1,1],
        [1,1,1,1,1],
        [1,1,1,1,0]
      ]
    }
  ],
  "11": [
    {
      "id": "11a",
      "grid": [
        [1,1,1,1,0,1,1,1,1,1,1],
        [1,1,1,1,0,1,1,1,1,1,1],
        [1,1,1,1,1,1,1,1,0,1,1],
        [1,1,1,0,1,1,1,0,1,1,1],
        [0,0,1,1,1,1,0,1,1,1,1],
        [1,1,1,1,1,0,1,1,1,1,1],
        [1,1,1,1,0,1,1,1,1,0,0],
        [1,1,1,0,1,1,1,0,1,1,1],
        [1,1,0,1,1,1,1,1,1,1,1],
        [1,1,1,1,1,1,0,1,1,1,1],
        [1,1,1,1,1,1,0,1,1,1,1]
      ]
    },
    {
      "id": "11b",
      "grid": [
        [1,1,1,0,1,1,1,0,1,1,1],
        [1,1,1,0,1,1,1,1,1,1,1],
        [1,1,1,1,1,1,0,1,1,1,1],
        [0,1,1,1,1,0,1,1,1,1,0],
        [1,1,1,1,0,1,1,1,0,1,1],
        [1,1,0,1,1,1,1,1,0,1,1],
        [1,1,0,1,1,1,0,1,1,1,1],
        [0,1,1,1,1,0,1,1,1,1,0],
        [1,1,1,1,0,1,1,1,1,1,1],
        [1,1,1,1,1,1,1,0,1,1,1],
        [1,1,1,0,1,1,1,0,1,1,1]
      ]
    },
    {
      "id": "11c",
      "grid": [
        [1,1,1,1,1,0,1,1,1,1,1],
        [1,1,1,1,0,1,1,1,1,1,1],
        [1,1,1,1,1,1,1,0,1,1,1],
        [1,1,0,1,1,1,0,1,1,0,1],
        [1,1,1,1,0,1,1,1,1,1,1],
        [0,1,1,0,1,1,1,0,1,1,0],
        [1,1,1,1,1,1,0,1,1,1,1],
        [1,0,1,1,0,1,1,1,0,1,1],
        [1,1,1,0,1,1,1,1,1,1,1],
        [1,1,1,1,1,1,0,1,1,1,1],
        [1,1,1,1,1,0,1,1,1,1,1]
      ]
    }
  ]
}
